**********
*P       *
*        *
*      M *
*        *
*    G   *
*********